военного	военный	военн					
дефолт	дефолт	дефолт					
Договор	Договор	договор					
Конституции	Конституции	конституциj					
просвященного	просвященный	просвящ					
разрядки	разрядка	разрядк					
Русская	Русская	русск					
Смута	Смута	смут					
Эпоха	Эпоха	эпох					
гайдаровские	гайдаровский	гайдаровск					
новое	новый	но					
оттепель	оттепель	оттепель					
было	быть	бы					
века	век	век					
веке	век	*					
веку	век	*					
вошла	войти	воj					
выделите	выделить	выдели					
год	год	год					
году	год	*					
году	год	*					
году	год	*					
году	год	*					
годы	год	*					
государственной	государственный	государственн					
день	день	день					
десятилетие	десятилетие	десятилетиj					
десятилетия	десятилетие	*					
десятилетия	десятилетие	*					
десятилетиям	десятилетие	*					
конец	конец	конец					
месяц	месяц	месяц					
национали	национализация	национализациj					
после	после	после					
прежде	прежде	прежде					
преобразование	преобразование	преобразованиj					
стал	стать	ста					
стало	стать	*					
укажите	указать	указа					
укажите	указать	*					
укажите	указать	*					
указать	Указать	*					
указать	указать	*					
явился	явиться	яви				
берлинской	берлинский	берлинск					
борьба	борьба	борьб					
диссидентами	диссидент	диссидент					
застоя	застой	застой					
развернутому	развернуть	раверну					
разрядки	разрядка	рязрядк					
ускорение	ускорение	ускорениj					
Апрельских	Апрельский	апрельск					
Беловежские	Беловежские	беловежск					
белого	белый	бел					
Бунташным	Бунташным	бунташн					
Вести	весть	весть					
Военного	военный	военн					
коммунизма	коммунизм	коммунизм					
вольных	вольный	вольн					
Вооруженного	вооружать	вооружи					
Городское	Городской	городск					
Доктрина	Доктрина	доктрин					
Заповедные	заповедный	заповедн					
Звезда	Звезда	звезд					
князь	князь	князь					
кровавого	кровавый	кровав					
Кухаркиных	Кухарка	кухарк					
латифундия	латифундия	латифундиj					
Ленинград	Ленинград	ленинград					
Новая	Новый	нов					
новой	новый	*					
Оттепели	Оттепель	оттепель					
охоту	охота	охот					
самой	самый	самый					
первой	первый	перв					
Положение	Положение	положениj					
Правового	Правовой	правов					
правый	правый	прав					
Превратить	Превратить	преврати					
Превращения	Превращение	превращениj					
Соборное	соборный	соборн					
Уставная	уставный	уставн					
холодной	холодный	холодн					
царя-освободителя	царь	царь					
Шахтинскому	Шахтинский	Шахтинск					
освободитель	освободитель	освободитель					
мировой	мировой	миров					
А.А.Блок	А.А.Блок						
А.В.Колчак	А.В.Колчак						
А.Д.Михайлов	А.Д.Михайлов						
А.И.Герцен	А.И.Герцен						
А.И.Гучков	А.И.Гучков						
А.И.Деникин	А.И.Деникин						
А.И.Желябов	А.И.Желябов						
А.И.Солженицын	А.И.Солженицын						
А.М.Бутлеров	А.М.Бутлеров						
А.М.Василевский	А.М.Василевский						
А.М.Горький	А.М.Горький						
А.Меншиков	А.Меншиков						
А.Н.Радищев	А.Н.Радищев						
А.Н.Туполев	А.Н.Туполев						
А.П.Чехов	А.П.Чехов						
А.Рублев	А.Рублев						
А.С.Пушкин	А.С.Пушкин						
А.Тойнби	А.Тойнби						
А.Ф.Керенский	А.Ф.Керенский						
А.Фиорованти	А.Фиорованти						
абсолютизма	абсолютизм	абсолютизм					
абсолютистские	абсолютистский	абсолютистск					
Абсолютная	Абсолютный	абсолютн					
августа	август	август					
августу	август	*					
Австрией	Австрия						
Австро-Венгрия	Австро-Венгрия						
автономными	автономный	автономн					
автором	автор	автор					
аграрная	аграрный	аграрн					
аграрной	аграрный	*					
агрессии	агрессия	агрессиj					
административных	административный	административн					
Азии	Азия	азиj					
акт	акт	акт					
акта	акт	*					
активно	активно	активно					
Александр	Александр	александр					
Александра	Александр	*					
Александра	-	*					
Александре	Александр	*					
Александром	Александр	*					
Алексей	Алексей	алексеj					
Алексея	Алексей	*					
Альтернатива	Альтернатива	альтернатив					
альтернативных	альтернативный	альтернативн					
альтернативы	альтернатива	альтернатив					
амнистию	амнистия	амнистиj					
анализе	анализ	анализ					
Андропова	Андропов	андропов					
Антанте	Антанта	антант					
Антанты	Антанта	*					
антикоминтерновский	антикоминтерновский	антикоминтерновск					
апреле	апрель	апрель					
апреля	апрель	*					
арене	арена	арен					
армии	армия	армиj					
армии	армия	*					
армию	армия	*					
армия	армия	*					
Аскольда	Аскольд	аскольд					
атомной	атомный	атомн					
атомный	атомный	*					
Афганистан	Афганистан	афганистан					
Афганистана	Афганистан	*					
Б.Н.Ельцин	Б.Н.Ельцин						
базируется	базироваться	базирова	ся	77			
базы	база	баз					
Белоруссии	Белоруссия	белоруссиj					
Берлине	Берлин	берлин					
беспросветное	беспросветный	беспросветн					
Битва	Битва	битв					
битвы	битва	*					
благодаря	благодарить	благодари		77			
ближайших	ближайший	ближайш					
близость	близость	близость					
блок	блок	блок					
блоки	блок	*					
боевых	боевой	боев					
боеспособной	боеспособной	боеспособн					
Большевизация	Большевизация	большевизациj					
большевикам	большевик	большевик					
большевиками	большевик	*					
большевики	большевик	*					
большевиков	большевик	*					
большинство	большинство	большинств					
Борис	Борис	борис					
бороться	бороться	боро	ся				
борьба	борьба	борьб					
борьбе	борьба	*					
борьбы	борьба	*					
Брежнева	Брежнев	брежнев					
Брест-Литовске	Брест-Литовский	Брест-Литовск					
Брестского	Брестский	брестск					
Брестской	Брестский	*					
Брестскому	Брестский	*					
будет	быть	бы					
Булгарии	Булгария	булгари					
буржуазии	буржуазия	буржуази					
бывшая	быть	бы					
бывшими	быть	*					
был	быть	*					
был	быть	*					
было	быть	*					
была	быть	*					
была	быть	*					
были	быть	*					
были	быть	*					
было	быть	*					
Быстро	Быстро	быстро	быстр
быстрыми	быстрый	быстр					
В.А.Жуковский	В.А.Жуковский						
В.А.Серов	В.А.Серов						
В.В.Маяковский	В.В.Маяковский						
В.В.Путин	В.В.Путин						
В.В.Растрелли	В.В.Растрелли						
В.Г.Белинский	В.Г.Белинский						
В.Г.Перов	В.Г.Перов						
В.И.Баженов	В.И.Баженов						
В.И.Ленин	В.И.Ленин						
В.М.Васнецов	В.М.Васнецов						
В.М.Молотов	В.М.Молотов						
В.М.Шукшин	В.М.Шукшин						
В.Н.Татищев	В.Н.Татищев						
В.П.Астафьев	В.П.Астафьев						
важнейшей	важный	важн					
важнейшими	важный	*					
важное	важный	*					
важной	важный	*					
Важные	Важный	*					
важными	важный	*					
валового	валовый	валов					
вариант	Вариант	вариант					
вариант	вариант	*					
варианты	вариант	*					
Варшавского	Варшавский	Варшавск					
Василий	Василий	Василий					
ваучер	ваучер	ваучер					
ваучерной	ваучерный	выучерн					
введена	ввести	введ					
введение	введение	введениj					
введения	введение	*					
введенная	Введенный	введенн					
введенный	введенный	*					
введено	ввести	введ					
введены	ввести	*					
ввел	ввести	*					
ввел	ввести	*					
ввел	ввести	*					
ввод	ввод	ввод					
ввода	ввод	ввод					
ведения	ведения	ведениj					
ведущую	вести	вед					
века	век	век					
века	век	*					
века	век	*					
веков	век	*					
веком	век	*					
вела	вести	вес					
великое	великий	велик					
великой	великий	*					
велись	вести	вес					
величества	величество	величеств					
Венгерский	Венгерский	Венгерск					
вернулись	вернуться	верну	ся				
верный	верный	верн					
Верховного	Верховный	верховн					
Верховным	Верховный	*					
вести	вести	вес					
вече	вече	вече					
вечевые	вечевой	вечев					
взаимной	взаимный	взаимн					
взаимовлияние	взаимовлияние	взаимовлияниj					
взаимовлиянии	взаимовлияние	*					
взаимодействие	взаимодействие	взаимодействиj					
взаимодействии	взаимодействие	*					
Взаимопомощи	Взаимопомощь	взаимопомощь					
взглядами	взгляд	взгляд					
взят	взять	взя					
взятия	взятие	взятиj					
видения	видение	видениj					
вклад	вклад	вклад					
владельцев	владелец	владелец					
владение	владение	владениj					
Владимир	Владимир	владимир					
Владимира	Владимир	*					
властей	власть	власть					
власти	власть	*					
властных	властный	властн					
власть	власть	власть					
влиять	влиять	влия					
вмешательство	вмешательство	вмешательств					
внесших	внести	внес					
внешней	внести	*					
внимания	внимание	вниманиj					
внутреннего	внутренний	внутренн					
внутренней	внутренний	*					
внутренние	внутренний	*					
внутриполитическое	внутриполитический	внутриполитическ					
воду	вода	вод					
военная	военный	военн					
военной	военный	*					
военно-политической	военно-политический	военно-политическ					
Военно-революционный	Военно-революционный	Военно-революционн					
военную	военный	военн					
военные	военный	*					
военный	военный	*					
военным	военный	*					
военных	военный	*					
возвышения	возвышение	возвышениj					
возглавил	возглавить	возглави					
возглавил	возглавить	*					
воззвании	воззвание	воззваниj					
возможные	возможный	возможн					
возникновения	возникновение	возникновениj					
возникновения	возникновение	*					
возникшая	возникать	возника					
возникшие	возникать	*					
войн	война	войн					
война	война	*					
войне	война	*					
войне	война	*					
воинская	воинский	воинск					
войну	война	войн					
войну	война	*					
войны	война	*					
войны	война	*					
войны	война	*					
войск	войско	войск					
войска	войско	*					
Волжской	волжский	волжск					
волны	волна	волн					
вольных	вольный	вольн					
волю	воля	вол					
Вооруженное	Вооруженный	вооруженн					
вооруженному	вооруженный	*					
вопрос	вопрос	вопрос					
вопроса	вопрос	*					
вопросах	вопрос	*					
вопросе	вопрос	*					
вопросы	вопрос	*					
Воробьевых	Воробьевый	Воробьев					
воскресения	воскресение	воскресениj					
восстание	восстание	восстаниj					
восстанием	восстание	*					
восстанию	восстание	*					
восстания	восстание	*					
восстания	восстание	*					
восстановить	восстановить	восстанови					
восстановлению	восстановление	восстановлени
востоке	восток	восток
Востоке	Восток	Восток					
Восточной	Восточной	Восточн					
Восточной	Восточный	*					
Восточные	Восточный	*					
Восточных	Восточный	*					
вошел	войти	вой					
вошли	войти	*					
вошло	войти	*					
впервые	впервые	впервые					
времена	время	врем					
времени	время	*					
временного	временный	временн					
временное	временный	*					
время	время	врем					
все	весь	весь					
всего	весь	*					
всем	весь	*					
всему	весь	*					
всеобщая	веобщий	всеобщ					
трудовая	трудовой	трудов					
Всероссийским	Всероссийский	Всероссийск					
всех	весь	весь					
всея	весь	*					
вспомогательная	вспомогательный	вспомогательн					
встретились	встретиться	встрети	ся				
встреча	встреча	встреч					
вступили	вступить	вступи					
вступление	вступление	вступлениj					
вступления	вступление	*					
вся	весь	весь					
вторая	второй	втор					
второго	второй	*					
второй	второй	*					
входили	входить	входи					
входит	входить	*					
входят	входить	*					
вхождения	вхождение	вхождениj					
выборах	выборы	выбор					
выборов	выборы	*					
выборов	выбор	*					
выбран	выбрать	выбра					
вывод	вывод	вывод					
вывоз	вывоз	вывоз					
вывоза	вывоз	*					
Выдвижение	Выдвижение	выдвижениj					
выдвинули	выдвинуть	выдвину					
выдвинутая	выдвинутый	выдвинут					
выдвинутой	выдвинутый	*					
Выделите	Выделить	выдели					
вызваны	вызвать	вызва					
выполняли	выполнить	выполни					
выпуску	выпуск	выпуск					
выработке	выработка	выработк					
выражала	выражать	выража					
выражают	выражать	*					
высказывалось	высказывать	высказыва					
выступал	выступать	выступа					
выступали	выступать	*					
выступил	выступить	выступи					
выступила	выступить	*					
выступили	выступить	*					
Высшее	Высший	высш					
Высший	Высший	*					
высшую	высший	*					
высылку	высылка	высылк					
выхода	выход	выход					
вышли	выходить	выходи					
Выявление	выявление	выявлениj					
Г.Е.Зиновьев	Г.Е.Зиновьев						
Г.К.Жуков	Г.К.Жуков						
Г.М.Маленков	Г.М.Маленков						
Гайдара	Гайдар						
Гайдара	Гайдар						
генерал	генерал	генерал					
Генерального	Генеральный	генеральн					
Генуэзской	Генуэзский						
географически	географический	географическ					
географических	географический	*					
Германией	Германия						
Германии	Германия						
Германия	Германия						
героев	герой	герой					
гибелью	гибель	гибель					
Гитлера	Гитлер	гитлер					
гитлеровское	гитлеровский	гитлеровск					
гитлеровской	гитлеровский	*					
Главная	Главный	главн					
Главное	Главный	*					
главное	главный	*					
Главной	Главный	*					
Главнокомандования	Главнокомандование	главнокомандованиj					
Главнокомандующим	Главнокомандующий	главнокомандующ					
Главную	Главный	главн					
Главные	Главный	*					
Главный	Главный	*					
Главным	Главный	*					
главой	глава	глав					
гласности	гласность	гласность					
гласность	гласность	*					
глобальная	глобальный	глобальн					
год	год	год					
год	год	*					
года	год	*					
годах	год	*					
годах	год	*					
годов	год	*					
годов	год	*					
году	год	*					
Годунов	Годунов	годунов					
Годы	Год	год					
горах	гора	гор					
Горбачев	Горбачев	горбачев					
Горбачева	Горбачев	*					
Горбачёва	Горбачёв	*					
городская	городской	городск					
городской	городской	*					
государств	государство	государств					
государства	государство	*					
государства	государство	*					
государстве	государство	*					
Государственная	Государственный	государственн					
государственного	государственный	*					
Государственной	Государственный	*					
государственности	государственность	государственность					
Государственную	Государственный	государственн					
Государственный	Государственный	*					
государственных	государственный	*					
государство	государство	государств					
Готовясь	Готовясь						
граждан	гражданин	гражданин					
граждан	гражданин	*					
гражданам	гражданин	*					
гражданин	гражданин	*					
Гражданская	Гражданский	гражданск					
гражданской	гражданский	*					
гражданскую	гражданский	*					
грамота	грамота	грамот					
грани	грань	грань					
границ	граница	границ					
Грозного	Грозный	грозн					
губернских	губернский	губернск					
Д.Д.Шостакович	Д.Д.Шостакович						
Д.И.Менделеев	Д.И.Менделеев						
дала	дать	да					
дали	дать	*					
Дальнем	Дальний	дальн					
дани	дань	дань					
Даниил	Даниил	даниил					
дат	дата	дат					
Датой	Дата	*					
Даты	Дата	*					
дают	давать	дава					
дающая	давать	*					
Два	Два	дв					
движение	движение	движениj					
движения	движение	*					
движения	движение	*					
Дворцовые	Дворцовый	дворцов					
Дворцовым	Дворцовый	*					
двух	два	дв					
действий	действие	действиj					
действительности	действительность	действительность					
действия	действие	действиj					
декабре	декабрь	декабрь					
декабристов	декабрист	декабрист					
декабря	декабрь	декабрь					
Декрет	Декрет	декрет					
Декретом	Декрет	*					
дела	дело	дел					
делает	делать	дела					
делегации	делегация	делегациj					
делегациями	делегация	*					
делу	дело	дело					
демократизации	демократизация	демократизациj					
демократизацию	демократизация	*					
демократизация	демократизация	*					
демократической	демократический	демократическ					
демократическую	демократический	*					
деревне	деревня	деревнj					
державу	держава	держав					
Деспотичная	Деспотичный	деспотичн					
детях	дети	детj					
дефолт	дефолт	дефолт					
деятельности	деятельность	деятельность					
деятельность	деятельность	*					
деятеля	деятель	деятель					
диалектико-материалистической	диалектико-материалистический	диалектико-материалистическ					
диктатуру	диктатура	диктатур					
диктатуры	диктатура	*					
династии	династия	династиj					
Дира	Дира	дир					
диссидентского	диссидентский	диссидентск					
дисциплина	дисциплина	дисциплин					
дисциплину	дисциплина	*					
Дмитрий	Дмитрий						
добиться	добиться	доби	ся				
добровольности	добровольность	добровольность					
довоенного	довоенный	довоенн					
договор	договор	договор					
договора	договор	*					
договоры	договор	*					
доктрина	доктрина	доктрин					
доктрины	доктрина	*					
документ	документ	документ					
Долгорукий	Долгорукий						
должность	должность	должность					
Донской	Донской						
достиг	достигнуть	достигну					
достигнуть	достигнуть	*					
достижения	достижение	достижениj					
достоянием	достояние	достояниj					
др.	направлять	направля					
Древляне	Древлянин	древлянин					
Древнерусского	Древнерусский	древнерусск					
Древнерусского	Древнерусский	*					
Древнерусское	Древнерусский	*					
другие	другой	друг					
других	другой	*					
Дуалистический	Дуалистический	даулистическ					
Дума	Дума	дум					
думе	дума	*					
Думой	Дума	*					
Думу	дума	*					
думы	дума	*					
Духовная	Духовный	духовн					
духовной	духовный	*					
духовном	духовный	*					
духовности	духовность	духовность					
духовные	духовный	духовн					
Е.Пугачева	Е.Пугачев						
Европе	Европа	европ					
европейского	европейского	европейск					
Европы	Европа	европ					
Его	он	он					
ее	она	она					
единого	единый	един					
единое	единый	*					
единства	единство	единств					
Екатерины	Екатерина						
Екатерины	Екатерина						
ЕкатериныII	ЕкатеринаII						
жандармов	жандарм	жандарм					
ждать	ждать	жда					
женское	женский	женск					
жизни	жизнь	жизнь					
жизни	жизнь	*					
жизнь	жизнь	*					
жилищной	жилищный	жилищн					
журналах	журнал	журнал					
Завершение	Завершение	завершениj					
завершения	завершение	завершениj					
завершенной	завершенный	завершенн					
завершилась	завершить	заверш					
завершилось	завершить	*					
зависимость	зависимость	зависимость					
завоевания	завоевание	завоеваниj					
задача	задача	задач					
задачей	задача	*					
зажиточных	зажиточный	зажиточн					
закладыванию	закладывание	закладываниj					
заключается	заключаться	заключа	ся				
заключается	заключаться	*					
заключается	заключаться	*					
заключалась	заключаться	*					
заключен	заключить	заключ					
Заключение	Заключение	заключениj					
заключению	заключение	*					
заключенных	заключенный	заключенн					
законов	закон	закон					
законодательная	законодательный	законодательн					
законодательной	законодательный	*					
законодательную	законодательный	*					
Законодательный	Законодательный	*					
законодательных	законодательный	*					
законодательства	законодательство	законодательств					
законом	закон	закон					
закономерностей	закономерность	закономерность					
закономерности	закономерность	*					
законы	закон	закон					
закреплены	закрепить	закрепи					
замена	замена	замен					
занималось	заниматься	занима	ся				
занявшего	занять	заня					
занял	занять	*					
Западниками	Западник	западник					
западничества	западничество	западничеств					
Западной	Западный	западн					
Западной	Западный	*					
западными	западный	*					
Западных	Западный	*					
запрещена	запретить	запрети					
запущен	запустить	запусти					
заседаниях	заседание	заседаниj					
заседатели	заседатель	заседатель					
застоя	застой	застой					
Заточник	Заточник	заточник					
зафиксировала	зафиксировать	зафиксирова					
Захват	Захват	захват					
захватническую	захватнический	захватническ					
зация	промышленность	промышленность					
Защищать	Защищать	защища					
Заявление	Заявление	заявлениj					
земель	земеля	земелj					
земель	земля	земл					
Земельное	Земельный	земельн					
земле	земля	земл					
землевладения	землевладение	землевладениj					
Земли	Земля	земл					
землю	земля	*					
землю	земля	*					
Земская	Земский	земск					
Земский	Земский	*					
земских	земский	*					
земской	земский	*					
Знаменитая	Знаменитый	знаменит					
Знаменитое	Знаменитый	*					
знание	знание	знаниj					
значительно	значительный	значительн					
знающим	знать	зна					
золотое	золотой	золот					
Золотой	Золотой	*					
зрелой	зрелый	зрел					
зрения	зрение	зрениj					
И.А.Бунин	И.А.Бунин						
И.Барма	И.Барма						
И.В.Курчатов	И.В.Курчатов						
И.В.Сталин	И.В.Сталин						
И.И.Вацетис	И.И.Вацетис						
И.П.Павлов	И.П.Павлов						
Иван	Иван						
Ивана	Иван						
ига	иго	иг					
игом	иго	*					
Игорь	Игорь						
играли	играть	игра					
идеалы	идеал	идеал					
Идейное	Идейный	идейн					
идеологии	идеология	идеологиj					
идея	идея	идеj					
избран	избрать	избра					
Избранной	Избранный	избранн					
известны	известный	известн					
изменение	изменение	изменениj					
Изменения	Изменение	*					
изменился	изменяться	изменя	ся				
изучающая	изучать	изуча					
изучение	изучение	изучениj					
изучению	изучение	*					
изучения	изучение	*					
имел	иметь	име					
имели	иметь	*					
имело	иметь	*					
имен	имя	им					
именами	имя	*					
именем	имя	*					
именуемый	именовать	имену		именова			
имеющих	иметь	име					
имеющих	иметь	*					
императора	император	император					
императором	император	*					
Императорского	Императорский	имераторск					
империалистической	империалистический	империалистическ					
империалистическую	империалистический	*					
империей	империя	империj					
империи	империя	*					
империи	империя	*					
импульс	импульс	импульс					
имущества	имущество	имуществ					
Индустриализацией	Индустриализация	индустриализациj					
индустриализации	индустриализация	*					
индустриализации	Индустриализация	*					
индустриальную	индустриальный	индустриальн					
инициативой	инициатива	инициатив					
Инициатором	Инициатор	инициатор					
иностранной	иностранный	иностранн					
иностранных	иностранный	*					
Интервенцией	Интервенция	интервенциj					
интересы	интерес	интерес					
иные	иной	ин					
искусственный	искусственный	искуственн					
Ислам	Ислам	ислам					
исполнительной	исполнительный	исполнительн					
испытание	испытание	испытаниj					
исследование	исследование	исследованиj					
исследованию	исследование	*					
исследования	исследование	*					
истории	история	историj					
историческая	исторический	исторически					
исторические	исторический	*					
исторический	исторический	*					
историческим	исторический	*					
исторических	исторический	*					
исторического	исторический	*					
исторической	исторический	*					
историческом	исторический	*					
источника	источник	источник					
источников	источник	*					
итог	итог	итог					
Итоги	Итог	*					
Итогом	Итог	*					
июня	июнь	июнь					
июня	июнь	*					
К.А.Тимирязев	К.А.Тимирязев						
К.Е.Ворошилов	К.Е.Ворошилов						
К.К.Рокоссовский	К.К.Рокоссовский						
К.П.Брюллов	К.П.Брюллов						
Каганат	Каганат	каганат					
каждый	каждый	кажд					
казаков	казак	казак					
Какие	Какой	какой					
каким	какой	*					
Какое	Какой	*					
Какой	Какой	*					
Калита	Калита	калит					
Калке	Калка	калк					
кампания	кампания	кампаниj					
канцелярии	канцелярия	канцеляриj					
капитал	капитал	капитал					
капитала	капитал	*					
капитализма	капитализм	капитализм					
капиталовложения	капиталовложение	капиталовложениj					
Капитуляция	Капитуляция	капитуляциj					
карибский	карибский	карибск					
Карибского	Карибский	*					
карточной	карточный	карточн					
касался	касаться	каса	ся				
катастрофа	катастрофа	катастроф					
качестве	качество	качеств					
Киевский	Киевский	киевск					
Киевских	Киевский	*					
Киевского	Киевский	*					
Киевской	Киевский	*					
Киевскую	Киевский	*					
Кирова	Киров	киров					
классовой	классовый	классов					
классовые	классовый	*					
классы	класс	класс					
климате	климат	климат					
Ключевая	Ключевой	ключев					
Клятву	Клятва	клятв					
княжение	княжение	княжениj					
княжеств	княжество	княжеств					
княжества	княжество	*					
князей	князь	князь					
князем	князь	*					
князь	князь	*					
князья	князь	*					
князя	князь	*					
кодификация	кодификация	кодификациj					
коллективизации	коллективизация	коллективизациj					
коллективного	коллективный	коллективн					
колониальной	колониальный	колониальн					
Командно-административная	Командно-административный	командно-административн					
комиссии	комиссия	комиссиj					
комиссия	комиссия	*					
комитет	комитет	комитет					
коммунизма	коммунизм	коммунизм					
коммунизма	являться	явля	ся				
система	система	систем					
комплектования	комплектование	комплектованиj					
конкретные	конкретный	конкретн					
конкуренции	конкуренция	конкуренциj					
конституции	конституция	конституциj					
конституционная	конституционный	конституционн					
конституционного	конституционный	*					
конституция	конституция	конституциj					
Контрреформы	Контрреформа	контрреформ					
Контрреформы-это	Контрреформа	*					
конференции	конференция	конференциj					
конференция	конференция	*					
конфессиональной	конфессиональный	конфессиональн					
конфискацию	конфискация	конфискациj					
конфликте	конфликт	конфликт					
конфронтации	конфронтация	конфронтациj					
конца	конец	конец					
конца	конец	*					
конце	конец	*					
конце	конец	*					
концепции	концепция	концепциj					
концепция	концепция	*					
концу	конец	конец					
коренились	корениться	корени	ся				
коренного	коренной	коренн					
Корниловского	Корниловский	корниловск					
корпуса	корпус	корпус					
космополитизма	космополитизм	космополитизм					
космополитизмом	космополитизм	*					
космос	космос	космос					
космоса	космос	*					
космосе	космос	*					
которая	который	котор					
которого	который	*					
которое	который	*					
которой	который	*					
которую	который	*					
который	который	*					
которым	который	*					
которыми	который	*					
которых	который	*					
КПРФ	КПРФ						
КПСС	КПСС						
крайне	крайний	крайн					
Красной	Красный	красн					
крепости	крепость	крепость					
крепостного	крепостной	крепостн					
крепостное	крепостной	*					
крепостные	крепостной	*					
крестьян	крестьянин	крестьянин					
крестьяне	крестьянин	*					
крестьянская	крестьянский	крестьянск					
крестьянских	крестьянский	*					
крестьянской	крестьянский	*					
Крестьянскую	крестьянский	*					
Кризис	Кризис	кризис					
кризиса	кризис	*					
критиковать	критиковать	критикова					
критикующее	критиковать	*					
критической	критический	критическ					
Кронштадского	Кронштадский	кронштадск					
кружка	кружок	кружок					
Крупнейшее	Крупнейший	крупнейш					
крупной	крупный	крупнейш					
крупные	крупный	крупн					
крупным	крупный	*					
Крымской	Крымский	крымск					
тем	тот	то					
Кубе	Куба	куб					
кулачество	кулачество	кулачеств					
Куликовская	Куликовский	куликовск					
Куликовском	Куликовский	*					
Культ	Культ	культ					
культа	культ	*					
Культурная	культурный	культурн					
культурной	культурный	*					
культуры	культура	культур					
культуры	культура	*					
курировал	курировать	курирова					
курс	курс	курс					
Курская	Курский	курск					
Л.Б.Каменев	Л.Б.Каменев						
Л.Д.Троцкий	Л.Д.Троцкий						
Л.И.Брежневым	Л.И.Брежнев						
Л.Л.Берия	Л.Л.Берия						
Л.М.Каганович	Л.М.Каганович						
Л.Н.Толстой	Л.Н.Толстой						
левых	левый	лев					
ледокол	ледокол	ледокол					
лежит	лежать	лежа					
Лениным	Ленин	ленин					
лета	лето	лет					
летом	лето	*					
либерализации	либерализация	либерализациj					
Либеральное	Либеральный	либеральн					
либеральные	Либеральный	*					
Лигу	Лига	лиг					
Ликвидация	Ликвидация	ликвидациj					
литература	литература	литератур					
литературы	литература	*					
личностей	личность	личность					
личности	личность	*					
лишний	лишний	лишн					
логический	логический	логическ					
лозунг	лозунг	лозунг					
лозунгом	лозунг	*					
лозунгу	лозунг	*					
лучше	лучший	лучш					
людей	люди	люд					
людей	люди	*					
людям	люди	*					
М.А.Бакунин	М.А.Бакунин						
М.Б.Барклай-де-Толли	М.Б.Барклай-де-Толли						
М.В.Ломоносов	М.В.Ломоносов						
М.В.Фрунзе	М.В.Фрунзе						
М.И.Кутузов	М.И.Кутузов						
М.М.Сперанского	М.М.Сперанский						
М.Н.Тухачевский	М.Н.Тухачевский						
М.С.Горбачевым	М.С.Горбачев						
М.Ф.Казаков	М.Ф.Казаков						
М.Ю.Лермонтов	М.Ю.Лермонтов						
маловероятной	маловероятный						
Манифест	Манифест	манифест					
манифеста	манифест	*					
Манифестом	Манифест	*					
Манифесту	Манифест	*					
марта	март	март					
массовых	массовый	массов					
материальной	материальный	материальн					
мая	май	май					
международного	международный	международн					
международной	международный	*					
международных	международный	*					
межнациональные	межнациональный	межнациональн					
менталитет	менталитет	менталитет					
мер	мера	мер					
мерам	мера	*					
мероприятие	мероприятие	мероприятиj					
мероприятия	мероприятие	*					
мероприятиям	мероприятие	*					
местного	местный	местн					
место	место	мест					
месяц	месяц	месяц					
Метод	Метод	метод					
методов	метод	*					
милитаристской	милитаристский	милитаристск					
министерская	министерский	министерск					
Министерств	Министерство	министерств					
Минском	Минск	минск					
мира	мир	мир					
мире	мир	*					
мирного	мирный	мирн					
мирное	мирный	*					
мирные	мирный	*					
Мирный	Мирный	*					
мировая	мировой	миров					
мирового	мировой	*					
мировоззрение	мировоззрение	мировоззрениj					
мировой	мировой	миров					
мировую	мировой	*					
миру	мир	мир					
Михаил	Михаил	михаил					
Михайлович	Михайлович	михайлович					
Михайловича	Михайлович	*					
многих	многий	мног					
многообразии	многообразие	многообразиj					
Модель	Модель	модель					
Модернизация	Модернизация	модернизациj					
можно	можно	можно					
момента	момент	момент					
монархия	монархия	монархиj					
монархия	монарх	монарх					
монголо-татарами	монголо-татар	монголо-татар					
Монголо-татарским	Монголо-татарский	монголо-татарск					
монголо-татарского	Монголо-татарский	*					
монеты	монета	монет					
Мономах	Мономах	мономах					
монополий	монополия	монополиj					
Москве	Москва	москв					
Москвой	Москва	*					
Москву	Москва	*					
Москвы	Москва	*					
Московский	Московский	московск					
московскими	московский	*					
Московского	Московский	*					
мощный	мощный	мощн					
Мудрый	Мудрый	мудр					
мышление	мышление	мышлениj					
мышления	мышление	*					
Мюнхенский	Мюнхенский	мюнхенск					
мятежа	мятеж	мятеж					
Н.А.Морозов	Н.А.Морозов						
Н.А.Римский-Корсаков	Н.А.Римский-Корсаков						
Н.В.Гоголь	Н.В.Гоголь						
Н.Г.Чернышевский	Н.Г.Чернышевский						
Н.Данилевский	Н.Данилевский						
Н.И.Бухарин	Н.И.Бухарин						
Н.М.Карамзин	Н.М.Карамзин						
Н.М.Муравьева	Н.М.Муравьев						
Н.С.Хрущева	Н.С.Хрущев						
Н.С.Хрущевым?	Н.С.Хрущев						
наделённой	наделённый	наделенн					
наделены	наделить	надел					
надеялись	надеяться	надея	ся				
название	название	названиj					
названий	название	*					
назначен	назначать	назнача					
Назовите	Называть	называ					
Назовите	Называть	*					
называется	называется	называ	ся				
называется	называется	*					
называется	называется	*					
называется	называется	*					
называли	называть	называ					
называлось	называться	называ	ся				
называлось	называться	*					
называют	называть	называ					
Наиболее	Наиболее	наиболее					
Наибольшего	Наибольший	наибольше					
наибольшие	наибольший	*					
накануне	накануне	накануне					
Наличие	Наличие	наличиj					
нам	мы	мы					
намеревалась	намереваться	намерева	ся				
намеревались	намереваться	*					
наместниками	наместник	наместник					
намечалось	намечаться	намеча	ся				
нападении	нападение	нападениj					
Наполеона	Наполеон						
направлена	направить	направи					
направлением	направление	направлениj					
направленная	направленный	направленн					
направленные	направленный	*					
направленный	направленный	*					
направленным	направленный	*					
направлялись	направляться	направля	ся				
напряженности	напряженность	напряженность					
наркомом	нарком	нарком					
народа	народ	народ					
народа	народ	*					
народники	народник	народник					
народников	народник	*					
народного	народный	народн					
народов	народ	народ					
народов	народ	*					
Народовольцы	Народоволец	народоволец					
народовольцы	Александр						
населения	население	населениj					
наследственной	наследственный	наследственн					
настоящую	объявить						
наступательные	наступательный	наступательн					
наступательных	наступательный	*					
наступление	наступление	наступлениj					
наступлению	наступление	*					
наступления	наступление	*					
Наука	Наука	наук					
науке	наука	*					
науки	наука	*					
научно-обоснованного	научно-обоснованный	научно-обоснованн					
Научно-технической	Научно-технический	научно-техническ					
нацелена	нацелить	нацел					
наций	нация	нациj					
национальной	национальный	национальн					
национальные	национальный	*					
начала	начать	нача					
начала	начало	начал					
началась	начать	нача					
началась	начать	*					
начале	начало	начал					
начале	начало	*					
начались	начать	нача					
начало	начало	начал					
началом	начало	*					
начался	начать	нача					
началу	начало	начал					
начальников	начальник	начальник					
начальном	начальный	начальн					
Начатая	начать	нача					
начатой	начать	*					
начать	начать	*					
нашей	наш	наш					
Несовместимый	Несовместимый	несовместим					
неверный	неверный	неверн					
невмешательства	невмешательство	невмешательств					
Невского	Невский	невск					
недели	неделя	неделj					
Некоторая	Некоторый	некотор					
Нельзя	Нельзя						
Немецкий	Немецкий	немецк					
немецкого	немецкий	*					
ненападении	ненападение	ненападениj					
Необходимость	Необходимость	необходимость					
неповторимостиь	неповторимость	неповторимость					
неравномерное	неравномерный	неравномерн					
нерешенные	нерешенный	нерешенн					
нерушимости	нерушимость	нерушимость					
Несовместимым	Несовместимый	несовместим					
Нестор	Нестор						
неудач	неудача	неудач					
Николае	Николай						
Николай	Николай						
Николая	Николай						
Новая	Новый	нов					
Новгорода	Новгород						
Новгородской	Новгородский	новгородск					
Новгородскую	Новгород						
нового	Новгородский	нов					
новой	новый	*					
Новым	Новый	*					
норманнской	норманнский	норманнск					
нормах	норма	норм					
носило	носить	носи					
ноября	ноябрь	ноябрь					
НЭПа	НЭП	нэп					
НЭПом	НЭП	*					
НЭПу	НЭП	*					
О.Шпенглер	О.Шпенглер						
обвинялись	обвинить	обвин					
обеспечение	обеспечение	обеспечениj					
обеспечению	обеспечение	*					
обеспечил	обеспечить	обеспечи					
обеспечили	обеспечить	*					
обещано	обещать	обеща					
обладал	обладать	облада					
области	область	область					
обобщение	обобщение	обобщениj					
Оборона	Оборона	оборон					
оборонной	оборонный	оборонн					
обороны	оборона	оборон					
обрабатывает	обрабатывать	обрабатыва					
образован	образовать	образова					
Образование	Образование	образованиj					
образованием	образование	*					
образования	образование	*					
образования	образование	*					
образуется	образуется						
обратилось	обратиться						
обстановки	обстановка						
обсуждали	обсуждать						
обсуждался	обсуждать						
обсуждении	обсуждение						
обусловлен	обусловлен						
общенациональным	общенациональный						
обществ	общество						
общества	общество						
общественного	общественный						
общественной	общественный						
общественно-политической	общественно-политической						
общие	общий	общ					
общий	общий	*					
общины	община	общин					
объединению	объединение	объединениj					
объединения	объединение	*					
объединивший	объединить						
Объединяло	Объединять						
объективного	объективный	объективн					
объективности	объективность	объективность					
объявила	объявить						
объявили	объявить						
объявление	объявление	объявлениj					
обязанность	обязанность	обязанность					
ограждение	ограждение	ограждениj					
Одна	Один	один					
Одним	Один	*					
одно	один	*					
одновременно	одновременно						
Одной	Один	один					
оживления	оживление						
озера	озеро	озер					
ознаменовала	ознаменовать	ознаменова					
означал	означать						
оказалась	оказаться						
оказался	оказаться						
окончания	окончание						
Окончательное	Окончательный	окончательн					
окончательном	окончательный	*					
округа	округ	округ					
округов	округ	*					
октябре	октябрь	октябрь					
октябрьских	октябрьский	октябрьск					
Октябрьской	Октябрьский	*					
октября	октябрь	октябрь					
Олег	Олег						
Олимпиады	Олимпиада						
Ольга	Ольга						
он	он	он					
она	она	она					
они	они	они					
оно	оно	оно					
ООН	ООН						
опасностью	опасность						
оповестил	оповестить						
опора	опора						
оппозиция	оппозиция						
определений	определение						
определял	определять						
определяла	определяла						
определяются	определяться						
Опричнина	Опричнина						
опричного	опричный						
опыта	опыт						
орган	орган						
органа	орган						
органами	орган						
организации	организация						
Организация	Организация						
органов	орган						
органы	орган						
Орды	Орда						
оружия	оружие						
освобождались	освобождаться						
освобождение	освобождение						
освоение	освоение						
освоения	освоение						
ослабления	ослабление						
основ	основа	основ					
основана	основана						
основанное	основанный						
основе	основа	основ					
Основная	Основной	основн					
основного	основной	*					
Основной	Основной	*					
основные	основной	*					
основным	основной	*					
Основными	Основной	*					
основных	основной	*					
Основой	Основой	*					
основополагающие	основополагающий	основополагающ					
основывающаяся	основываться						
Особенность	Особенность	особенность					
Особенностью	Особенность	*					
остаточному	остаточный	остаточн					
осужден	осужден						
ответ	ответ	отве					
ответ	ответ	*					
отделение	отделение	отеделениj					
отдельного	отдельный	отдельн					
отечестве	отечество	отечеств					
Отечественной	Отечественный	отечественн					
открыт	открыт						
отложить	отложить						
отмена	отмена						
отмене	отмена						
отменить	отменить						
отмены	отмена						
отнести	отнести						
отнести	относить						
относительного	относительный	относительн					
относится	относиться						
относится	относится						
относится	гг.						
относятся	относятся						
относятся	относиться						
относящееся	относящееся						
отношение	отношение	отношениj					
отношении	отношение	*					
отношений	отношение	*					
отношению	отношение	*					
отношениях	отношение	*					
отражают	отражать						
отразилось	отразиться						
отраслях	отрасль						
отрекся	отречься						
отречения	отречение						
отставки	отставка						
отстранить	отстранить						
отчетливо	отчетливо						
официально	официально						
оформившие	оформившие						
оформлен	оформлен						
оценку	оценка						
очага	очаг	очаг					
П.А.Стлыпина	П.А.Стлыпина						
П.И.Багратион	П.И.Багратион						
П.И.Пестеля	П.И.Пестель						
П.И.Чайковский	П.И.Чайковский						
П.Л.Капица	П.Л.Капица						
П.Л.Лавров	П.Л.Лавров						
П.Н.Врангель	П.Н.Врангель						
П.Н.Милюков	П.Н.Милюков						
П.Н.Ткачев	П.Н.Ткачев						
П.Яковлев	П.Яковлев						
пакт	пакт	пакт					
пакта	пакт	*					
партии	партия	партиj					
партий	партия	*					
партию	партия	*					
партия	партия	*					
Паспортную	Паспортный	паспортн					
пата	пат	пат					
патриаршества	патриаршество	патриаршеств					
Первая	Первый	перв					
Первейшей	Первейший	первейш					
Первенство	Первенство	первенств					
Первичные	Первичный	первичн					
первичных	первичный	*					
первого	первый	перв					
Первое	Первый	*					
Первой	Первый	*					
Первой	Первый	*					
первоначально	первоначальный	первоначальн					
Первую	Первый	перв					
первые	первый	*					
Первый	Первый	*					
первым	первый	*					
первыми	первый	*					
первых	первый	*					
переводу	перевод	перевод					
переворот	переворот	переворот					
переворота	переворот	*					
переворотом	переворот	*					
перевороты	переворот	*					
переговорах	переговоры	переговор					
переговоров	переговоры	*					
Переговоры	Переговоры	*					
перед	перед	перед					
передать	передать						
передаче	передача	передач					
передовиков	передовик	передовик					
перелома	перелом	перелом					
перемены	перемена	перемен					
переплетение	переплетение	переплетениj					
переселение	переселение	переселениj					
переход	переход	переход					
перехода	переход	*					
переходе	переход	*					
переходу	переход	*					
Период	Период	период					
периода	период	*					
периоде	период	*					
периоду	период	*					
Петербург	Петербург						
Петербурга	Петербург						
Петр	Петр						
Петра	Петр						
Петра	Петра						
ПетраI	ПетрI						
Петре	Петр						
Петровские	Петровский	петровск					
Петром	Петр						
печати	печать						
план	план	план					
плана	план	*					
планировало	планировать	планирова					
планы	план	план					
победа	победа	побед					
победного	победный	победн					
Победы	Победа	побед					
победы	победы	*					
поведение	поведение	поведениj					
повлёк	повлекать						
повлиял	повлиять						
Поводом	Повод	повод					
повторный	повторный	повторн					
Под	Под	под					
подавлении	подавление	подавлениj					
подать	подать						
подвергались	подвергаться						
подверглось	подверглось						
подготовка	подготовка	подготовк					
подготовки	подготовка	*					
поддержали	поддержить						
Поддерживать	Поддерживать						
поддерживать	обрабатывать						
подписал	подписать						
подписали	подписать						
подписан	подписан						
подписание	подписание						
подписанного	подписанного						
подписанный	подписанный						
подписаны	подписаны						
подразумевает	подразумевать						
Подушная	Подушный	подушн					
Подход	Подход	подход					
подъем	подъем	подъем					
позволил	позволить						
позволило	позволить						
позволяющая	позволять						
позже	позже						
позицию	позиция	позициj					
познавательной	познавательный	познавательн					
познания	познание	познаниеj					
показали	показать						
поле	поле	пол					
Полет	Полет	полет					
Политика	Политика	политик					
политике	политика	*					
политики	политика	*					
политики	политика	*					
политикой	политика	*					
Политикой	Политика	*					
политику	политика	*					
Политическая	Политический	политическ					
политические	политический	*					
Политический	Политический	*					
политическими	политический	*					
политических	политический	*					
политических	политический	*					
политического	политический	*					
политическое	политический	*					
политической	политический	*					
политическому	политический	*					
политическую	политический	*					
полно	полно	полно	полн				
полного	полный	полн					
полномочий	полномочие	полномочиj					
полнота	полнота	полнот					
полные	полный	полн					
половине	половина	половин					
положение	положение	положениj					
положения	положение	*					
получивший	получить						
получил	получать						
получил	получить						
получила	получить						
получили	получить						
получило	получить						
пользу	польза	польз					
пользуется	пользоваться	пользова	ся				
польского	польский	польск					
помещичьего	помещичий	помещич					
помощи	помощь	помощь					
понимается	пониматься						
понимание	понимание	пониманиj					
Понятие	Понятие	понятиj					
понятия	понятие	*					
поощрения	поощрение	поощрениj					
попытки	попытка	попытк					
Попытку	Попытка	*					
поражение	поражение	поражениj					
поражения	поражение	*					
поручению	поручение	поручениj					
порядки	порядок	порядок					
посадников	посадник	посадник					
поселений	поселение	поселениj					
после	после						
Послевоенное	Послевоенный	послевоенн					
послевоенной	послевоенный	*					
послевоенную	послевоенный	*					
послевоенные	послевоенный	*					
послевоенных	послевоенный	*					
последней	последний	последн					
последовательное	последовательный	последовательн					
последствием	последствие	последствиj					
Последствия	Последствие	*					
последствиям	последствие	*					
послужило	послужить						
Посполитой	Посполитая	посполит					
посредством	посредством						
пост	пост	пост					
поставленных	поставленный	поставленн					
постановлению	постановление	постановлениj					
посту	пост	пост					
потерпела	потерпеть						
потеряла	потерять						
потому	настоящий	настоящ					
потому	потому						
пошел	пойти						
появления	появление	появлениj					
права	право	прав					
правах	право	*					
правда	правда	правд					
правильное	правильный	правильн					
правильный	правильный	*					
правильным	правильный	*					
Правитель	Правитель	правитель					
правительства	правительство	правительств					
правительство	правительство	*					
правительством	правительство	*					
правления	правление	правлениj					
правления	правление	*					
право	право	прав					
правовых	правовой	правов					
празднование	празднование	празднованиj					
пребывания	пребывание	пребываниj					
превращение	превращение	превращениj					
предвидеть	предвидеть						
предводительством	предводительство	предводительств					
предлагал	предлагать						
предложений	предложение	предложениj					
предложенной	предложенной	предложенн					
предложил	предложить						
предметов	предмет	предмет					
предполагавшая	предполагавший	предполагавш					
предполагал	предполагать						
предполагала	предполагать						
предполагала	предпологать						
предполагали	предполагать						
предпринял	предпринять						
предприятий	предприятие	предприятиj					
председателем	председатель	председатель					
Председатель	Председатель	*					
Представителем	Представитель	представитель					
представительных	представительный	представительн					
представлена	представлена						
представлений	представление	представлениj					
представлял	представлять						
представляла	представлять						
представляло	представлять						
предусматривал	предусматривать						
предусматривала	предусматривать						
предусматривало	предусматривать						
предусматривалось	предусматривалось						
преемников	преемник	преемник					
Президент	Президент	президент					
президентом	президент	*					
президентских	президентский	президентск					
президенты	президент	президент					
преимущественного	преимущественный	преимущественн					
прекращение	прекращение	прекращениj					
преобразований	преобразование	преобразованиj					
преобразований	преобразование	*					
преобразования	преобразование	*					
преобразованиям	преобразование	*					
преобразовательной	преобразовательный	преобразовательн					
престола	престол	престол					
приватизации	приватизация	приватизациj					
Приватизация	Приватизация	*					
привела	привести						
привели	привести						
признавали	признавать						
признаками	признак	признак					
признание	признание	признаниj					
призывали	призывать						
принадлежала	принадлежать						
принадлежит	принадлежать						
принимал	принимать						
Принцип	Принцип	принцип					
принципа	принцип	*					
принципе	принцип	*					
принципов	принцип	*					
принципу	принцип	*					
Принципы	Принцип	*					
принявший	принимать						
принял	принять						
принят	принимать						
принят	принят						
принята	принята						
принятая	принятая						
принятие	принятие						
принятия	принятие						
принято	принять						
принято	принято						
принятое	принятый	принят					
принятой	принятый	*					
приняты	принятый	*					
Принятым	Принятый	*					
принятых	принятый	*					
Приоритетной	Приоритетный	приоритетн					
природе	природа	природ					
природных	природный	природн					
природы	природа	природ					
природы	природа	*					
присоединение	присоединение	присоединениj					
присоединены	присоединены						
присяжные	присяжный	присяжн					
прихода	приход	приход					
причин	причина	причин					
причинам	причина	*					
Причинами	Причина	*					
причине	причина	*					
Причиной	Причина	*					
Причины	Причина	*					
проблема	проблема	проблем					
проблемы	проблема	*					
проведена	провести	провед					
проведение	проведение	проведениj					
Провести	Провести	провес					
проводившейся	проводившийся	проводивш					
проводилась	проводить	проводи					
проводились	проводиться	проводи	ся				
проводимым	проводить	проводи					
проводит	проводить	*					
провозгласило	провозгласить	провозгласи					
провозгласить	провозгласить	*					
провозглашена	провозглашена						
Программа	Программа	программ					
программа	программа	*					
программной	программный	программн					
Программой	Программа	программ					
программу	программа	*					
программы	программа	*					
прогрессе	прогресс	прогресс					
продналогом	продналог	продналог					
Продразверстка	Продразверстка	продразверстк					
продразверстка	всеобщий	всеобщ					
продразверстки	продразверстка	продразверстк					
продукта	продукт	продукт					
продукции	продукция	продукциj					
Проект	Проект	проект					
проекта	проект	*					
проекту	проект	*					
производительных	производительный	производительн					
производства	производство	производств					
производственных	производственный	производственн					
произошедшее	произошедший	произошедш					
произошел	произойти	произой					
произошла	произойти	*					
произошла	произойти	*					
произошли	произойти	*					
произошли	произойти	*					
произошло	произойти	*					
произошло	произойти	*					
произошло	произойти	*					
происхождение	происхождение	происхождениj					
пролетариата	пролетариат	пролетариат					
Пролеткульт	Пролеткульт	пролеткульт					
Пролеткульта	Пролеткульт	*					
промышленного	промышленный	промышленн					
промышленности	промышленность	промышленность					
промышленности	промышленность	*					
промышленности	продразверстка	продразверстк					
Промышленный	Промышленный	промышленн					
промышленных	промышленный	*					
просвещения	просвещение	просвещениj					
прославленных	прославленный	прославленн					
прослеживаются	прослеживаться						
просьбой	просьба	просьб					
против	против						
противоречие	противоречие	противоречиj					
Противостояние	Противостояние	противостояниj					
протокол	протокол	протокол					
процесс	процесс	процесс					
процессам	процесс	*					
процессе	процесс	*					
процессов	процесс	*					
процессы	процесс	*					
прошлом	прошлое						
Пруссией	Пруссия						
Пруссии	Пруссия						
путем	путь	путь*					
пути	путь	*					
пятилетке	пятилетка	пятилетк					
пятилетку	пятилетка	*					
пятилетнего	пятилетний	пятилетн					
пятилетние	пятилетний	*					
пятилетний	пятилетний	*					
пятилеток	пятилетка	пятилетк					
Работа	Работа	работ					
работу	работа	*					
рабочих	требование	требованиj					
равенство	равенство	равенств					
равноправия	равноправие	равноправиj					
Радикальные	Радикальный	радикальн					
радиуса	радиус	радиус					
рады	рада	рад					
разбирательства	разбирательство	разбирательств					
Развертывание	Развертывание	развертываниj					
развивалась	развиваться						
развивали	развивать						
развивалось	развиваться						
развитие	развитие	развитиj					
развитии	развитие	*					
развитию	развитие	*					
развитию	развитие	*					
развития	развитие	*					
развития	развитие	*					
разграничении	разграничение	разграничениj					
Разгром	Разгром	разгром					
разгрома	разгром	*					
разгроме	разгром	*					
разгромлен	разгромить	разгроми					
разделения	разделение	разделениj					
разделов	раздел	раздел					
разделу	раздел	*					
раздробленности	раздробленность	раздробленность					
различные	различный	различн					
различных	различный	*					
размер	размер	размер					
размещения	размещение	размещениj					
разногласии	разногласие	разногласиj					
разных	разный	разн					
Разоблачение	Разоблачение	разоблачениj					
разработан	разработать						
разработку	разработка						
разрешило	разрешить						
разрушенное	разрушенное						
разума	разум						
Разъединяло	Разъединять						
ракет	ракета						
раньше	раньше						
расколол	расколоть						
Раскулачивание	Раскулачивание						
Распад	Распад						
распада	распад						
располагались	располагаться						
распространения	распространение						
распускаем	распускать						
распустить	распустить						
распущено	распущено						
рассматривать	рассматривать						
рассматривающий	рассматривать						
рассмотрении	рассмотрение						
реальности	реальность						
революцией	революция	революциj					
революции	революция	*					
революций	революция	*					
революции	революция	*					
революционного	революционный	революционн					
Революционное	Революционный	*					
революциюпередать	революция	революциj					
революция	революция	*					
регулярной	регулярный	регулярн					
режимы	режим	режим					
резиденции	резиденция	резиденциj					
резко	резко						
результат	результат	результат					
Результатами	Результат	*					
результате	Результат	*					
результате	результат	*					
результатов	результат	*					
Результатом	Результат	*					
Результаты	Результат	*					
Рейгана	Рейган	рейган					
Рейкьявике	Рейкьявик						
реке	река						
религиозный	религиозный						
религиозных	религиозный						
религию	религия						
рельсы	рельсы						
реорганизованы	реорганизованы						
репрессий	репрессия	репрессиj					
репрессиям	репрессия	*					
республик	республика	республик					
республика	республика	*					
республиками	республика	*					
республике	республика	*					
ресурсов	ресурс	ресурс					
реформ	реформа	реформ					
реформа	реформа	*					
Реформами	Реформа	*					
реформе	реформа	*					
Реформой	Реформа	*					
реформы	реформа	*					
реформы	реформа	*					
реформы	реформа	*					
Речи	Речь	речь					
решающей	решать	реша					
решение	решение	решениj					
решению	решение	*					
решил	решить	реши					
решило	решить	*					
Решительное	Решительный	решительн					
роли	роль	роль					
роль	роль	*					
Романовых	Романов						
Россией	Россия						
России	Россия						
России	России						
России	Россия						
Российская	Российский	российск					
российских	российский	*					
российского	российский	*					
российского	российский	*					
Российской	Российский	*					
Российской	российский	*					
российскую	российский	*					
Россию	Россия						
Россия	Россия						
рост	рост						
рубеже	рубеж						
рубля	рубль	рубль					
Руководители	Руководитель	руководитель					
руководитель	руководитель	*					
руководителями	руководитель	*					
руководства	руководство	руководств					
руководство	руководство	*					
руководством	руководство	*					
руководящей	руководящей	руководящ					
Румыния	Румыния						
Руси	Русь	русь					
Руси	Русь	*					
русская	русский	русск					
русские	русский	*					
русский	русский	*					
русских	русский	*					
русского	русский	*					
русской	русский	*					
русско-турецких	русско-турецкий	русско-турецк					
рыночной	рыночный	рыночн					
Рюриковичей	Рюрикович						
ряд	ряд						
рядовых	рядовой						
С.А.Есенин	С.А.Есенин						
С.В.Ильюшин	С.В.Ильюшин						
С.В.Рахманинов	С.В.Рахманинов						
С.Л.Перовская	С.Л.Перовская						
С.М.Буденный	С.М.Буденный						
С.М.Кирова	С.М.Киров						
С.П.Королев	С.П.Королев						
С.Ю.Витте	С.Ю.Витте						
самодержавием	самодержавие						
самодержавия	самодержавие						
самодержца	самодержец						
самостоятельного	самостоятельный						
самостоятельности	самостоятельность						
самоуправления	самоуправление						
самую	народоволец						
самых	самый						
сбор	сбор						
сбора	сбор						
сведения	сведение						
свержению	свержение						
свертывания	свертывание						
сверху	сверху						
светской	светской						
свидетельствовал	свидетельствовать	свидетельствова					
свидетельствовала	свидетельствовать	*					
свободной	свободный	свободн					
свободы	свобода	свобод					
Своебразное	Своебразный	своеобразн					
своему	свой	свой					
своему	свой	*					
своих	свой	*					
связано	связано						
связано	связать						
связаны	связаны						
связи	связи						
связывают	связывать						
Святейшего	Святейший						
Святой	Святой						
Святослав	Святослав						
Святославича	Святославич						
Святославом	Святослав						
сговор	сговор						
сделан	сделан						
сделано	сделано						
Северного	Северный	северн					
Северной	Северный	*					
секретаря	секретарь						
Секретный	Секретный	секретн					
сельского	сельский	сельск					
Сельское	сельский	*					
Сельское	Сельский	*					
сельском	сельский	*					
семилетней	семилетний	семилетн					
Сената	Сенат						
сентября	сентябрь						
середине	середина						
сил	сила						
силы	сила						
сильно	сильно						
Синод	Синод						
Синода	Синод						
Система	Система						
системе	система						
систему	систему						
системы	система						
системы	системыа						
ситуации	ситуация						
ситуация	ситуация						
скачкообразное	скачкообразный						
складываться	складываться						
славян	славянин						
славянофилов-это	славянофил						
славянофильства	славянофил						
Следствием	Следствие						
следующей	следующий						
следующей	следующей						
следующем	следующее						
следующем	следующем						
следующем	следующий						
следующие	следующий						
следующий	следующий						
следующими	следующий						
следующих	следующий						
Слияние	Слияние						
сложившихся	сложившихся						
сложилась	сложиться						
сложились	сложиться						
случае	случай						
Смена	Смена						
смены	смена						
смерти	смерть						
Смоленском	Смоленск						
Смутного	Смутный						
СНГ	СНГ						
снизу	снизу						
снять	снять						
собой	собой						
собой	представлять						
Собор	Собор						
Соборного	Соборное						
собрание	собрание						
собрания	собрание						
собственной	собственный						
собственности	собственность						
собственными	собственный						
событие	событие						
событием	событие						
событий	событие						
События	Событие						
событиями	события						
Совет	Совет						
Совета	Совет						
совета	совет						
Советам	Совет						
Советов	Совет						
Советская	Советский						
советские	советский						
Советский	Советский						
советских	советский						
советского	советский						
советское	советский						
советской	советский						
Советском	Советский						
Советскому	Советский						
Советско-финская	Советско-финская						
совещанием	совещание						
совокупность	совокупность						
современной	современный						
соглашение	соглашение						
соглашения	соглашения						
содержала	рабочий						
содержит	содержать						
созвана	созвать						
создали	создать						
создан	создан						
создана	создана						
создание	создание						
созданием	создание						
создании	создание						
созданию	созданию						
созданию	создание						
созданной	созданной						
созданные	созданные						
созданный	созданный						
созданы	созданы						
создать	создать						
сознании	сознание						
созыв	созыв						
сокращение	сокращение						
соответствие	соответствие						
соперничество	соперничество						
сосредоточена	сосредоточена						
состав	состав						
составляли	составлять						
Составной	Составной						
состоялось	состояться						
Состояние	Состояние						
состязательности	состязательность						
сосуществование	сосуществование						
сосуществования	сосуществование						
сотрудничества	сотрудничество						
социализма	социализм						
Социальная	Социальный						
социальной	социальной						
социальной	социальный						
социально-классовый	социально-классовый						
Социально-политические	Социально-политические						
Социально-экономическая	Социально-экономическая						
социально-экономического	социально-экономического						
социальную	социальный						
социальные	социальный						
Союз	Союз						
союза	союз						
Союзе	Союз						
Союзниками	Союзник						
союзники	союзники						
Союзного	Союзный						
Союзу	Союз						
специалисты	специалист						
список	список						
способ	способ						
способствовавший	способствовавший						
способствовал	способствовать	способствова					
способствовали	способствовать	*					
способствующая	способствовать	*					
способы	способ						
справедливые	поддерживать						
спутник	спутник						
спущенный	спущенный						
сражение	сражение						
среднего	средний						
Средней	Средний						
срочно	срочно						
ССР	ССР						
СССР	СССР						
стабилизации	стабилизация						
ставила	ставить						
ставилось	ставить						
Ставки	Ставка						
стал	стал						
стал	стать						
стала	стать						
стала	стала						
Сталина	Сталин						
Сталинградская	Сталинградский						
Сталинградской	Сталинградский						
стало	стать						
стало	стало						
становления	становление						
старые	старый						
статьи	статья						
стены	стена						
столицей	столица						
столкновения	столкновение						
Столыпина	Столыпин						
Столыпинская	Столыпинский						
столыпинской	столыпинский						
сторон	сторона						
стороне	сторона						
Сторонники	Сторонник						
сторонников	сторонник						
стран	страна						
странами	страна						
странах	страна						
стране	страна						
страной	страна						
страны	страна						
стратегическим	стратегический						
стремилась	стремиться						
строй	строй						
структуру	структура						
структуры	структура						
суда	суд						
судебного	судебный						
судетской	судетский						
судьбе	судьба						
Суть	Суть						
существовала	существовать	существова					
существования	существование	существованиj					
существующие	существующий	существующ					
Сущность	Сущность	сущность					
сфера	сфера	сфер					
сформировалась	сформироваться	сформирова	ся				
сформировался	сформироваться	*					
сформулированная	сформулированная	сформулированн					
сходные	сходный	сходн					
считал	считать						
считать	считать						
США	США						
съезд	съезд						
съезда	съезд						
съезде	съезд						
съездом	съезд						
сыграли	сыграть						
тайных	тайный						
таким	такой						
тактики	тактика						
танковое	танковый						
Татарстан	Татарстан						
Тегеранская	Тегеранский						
тезисах	тезис						
тем	тем						
тем	земля						
темное	темный						
темпами	темп						
тенденции	тенденция						
теории	теории						
терапия	терапия						
термоядерного	термоядерный						
территориальному	территориальный						
территории	территория						
террора	террор						
терроризмом	терроризм						
течение	течение						
тип	тип						
типа	типа						
титул	титул						
товаров	товаров						
только	только						
тот	тот						
точки	точка						
точкой	точка						
требования	справедливый						
требующий	требовать	требова					
трети	треть						
третьего	третий						
Третьеиюньский	Третьеиюньский						
трех	три						
трехсотлетия	трехсотлетие						
трехстороннего	трехсторонний						
Три	Три						
трудовая	повинность						
Трумэна	Трумэна						
тур	тур						
тысяцких	тысяцкий						
убеждении	убеждение						
убивший	убивать						
Убийство	Убийство						
убили	убить						
удалось	удалось						
удвоение	удвоение						
удельное	удельный						
удовлетворили	его						
уездных	уездный						
уже	уже						
укажите	указать						
Указ	Указ						
указа	указ						
указанные	указанные						
указанных	указанных						
указанных	указанный						
уклон	уклон						
уклона	уклон						
Украины	Украина						
укрепить	укрепить						
уложение	уложение						
Уложения	Уложение						
Уложенная	Уложенный						
Уложенной	Уложенной						
Умеренно-либеральная	Умеренно-либеральная						
Университетский	Университетский						
уничтожения	уничтожение						
упор	упор						
упорядочивший	упорядочить						
управление	управление						
управления	управление						
Упразднение	Упразднение						
уровень	уровень						
уровне	уровень						
уровня	уровень						
Усиление	Усиление						
ускоренной	ускоренной						
Условия	Условие						
успешных	успешный						
устав	устав						
установился	установиться						
установить	установить						
установления	установление						
устройства	устройство						
устройство	устройство						
устройству	устройство						
утверждении	утверждение						
утверждений	утверждение						
утвержденного	утвержденного						
утра	утро						
Ухудшение	Ухудшение						
участие	участие						
участковых	участковый						
Участники	Участник						
учебу	учеба						
учитывает	учитывать						
учитывать	учитывать						
учитывающих	учитывать						
Учредительного	Учредительный						
Учредительное	Учредительный						
учреждение	учреждение						
учреждений	учреждение						
Ф.Апраксин	Ф.Апраксин						
Ф.Г.Волков	Ф.Г.Волков						
Ф.Грек	Ф.Грек						
Ф.И.Шаляпин	Ф.И.Шаляпин						
Ф.И.Шубин	Ф.И.Шубин						
Ф.Лефорт	Ф.Лефорт						
Ф.М.Достоевский	Ф.М.Достоевский						
Фактор	Фактор	фактор					
факторов	фактор	*					
фамилию	фамилия	фамилиj					
фанатизм	фанатизм	фанатизм					
Феврале	Февраль	февраль					
Февральской	Февральский	февральск					
февраля	февраль	февраль					
федеральной	федеральный	федеральн					
Федеральные	Федеральный	*					
Федеральных	Федеральный	*					
Федеративного	Федеративный	федеративн					
федеративный	федеративный	*					
Федерации	Федерация	федерациj					
Федерация	Федерация	*					
Федорович	Федорович						
феодальной	феодальный	феодальн					
физиков-ядерщиков	физик-ядерщик	физик-ядерщик					
финансировалась	финансировать	физик-ядерщик					
финансирования	финансирование	финансированиj					
финансового	финансовый	финансов					
флота	флот	флот					
форм	форма	форм					
форма	форма	*					
формах	форма	*					
форме	форма	*					
формирование	формирование	формированиj					
формирования	формирование	*					
формирующая	формировать	формирова					
форму	форма	форм					
фраза	фраза	фраз					
Францией	Франция	франциj					
фронт	фронт	фронт					
фронту	фронт	*					
функцией	функция	функциj					
функции	функция	*					
Функция	Функция	*					
Хазарский	Хазарский	хазарск					
ханство	ханство	ханств					
характер	характер	характер					
характеризовалась	характеризовать	характеризова					
характеризует	характеризовать	*					
характеризуется	характеризовать	*					
характеризуется	характеризовать	*					
характеризуется	характеризовать	*					
характеризуют	характеризовать	*					
характеризующее	характеризовать	*					
характеристикам	характеристика	характеристик					
характерно	характерно	характерн					
характерноа	характерноа	*					
характерной	характерный	характерн					
характерны	характерный	*					
Характерными	Характерный	*					
Хасан	Хасан						
хлебопашцах	хлебопашец						
хлебопашцах	хлебопашцах						
Ход	Ход	ход					
ходе	ход	*					
хозяйств	хозяйство	хозяйств					
хозяйства	хозяйство	*					
хозяйстве	хозяйство	*					
хозяйство	хозяйство	*					
хотелось	хотеть						
христианства	христианство	христианств					
Христианство	Христианство	*					
Хрущев	Хрущев	хрущев					
Хрущева	Хрущев	*					
Хрущевской	Хрущевский	хрущевск					
Хрущевым	Хрущев	хрущев					
царствованию	царствование	царствованиj					
царствования	царствование	*					
царствования	царствование	*					
царя	царь	царь					
целей	цель	цель					
Цели	Цель	*					
целинных	целинный	целинн					
целое	целое	цел					
целом	целое	*					
цель	цель	цель					
целью	цель	*					
целями	цель	*					
ценности	ценность	ценность					
централизации	централизация	централизациj					
централизованного	централизованный	централизованн					
центрального	центральный	центральн					
церковью	церковь	церковь					
цивилизации	цивилизация	цивилизациj					
цивилизации	цивилизация	*					
цивилизаций	цивилизация	*					
часов	час	час					
частной	частный	частн					
частный	частный	*					
частью	часть	часть					
человечества	человечество	человечеств					
червонец	червонец	червонец					
Черненко	Черненко	черненк					
Чернобыльская	Чернобыльский	чернобыльск					
Чернобыльской	Чернобыльский	*					
Черносотенно-монархическая	Черносотенно-монархический	черносотенно-монархическ					
чертами	черта	черт					
чертой	черта	*					
черты	черта	*					
четверти	четверть	четверть					
четвертой	четвертый	четверт					
Чехословакией	Чехословакия	чехословакиj					
Чехословакию	Чехословакия	*					
Чехословацкой	Чехословацкий	чехословацк					
Чечне	Чечня	чечн					
числу	число	числ					
что	что	чей					
что	охота	охот					
чья	чей	чей					
шагом	шаг	шаг					
Швецией	Швеция	швециj					
школы	школа	школ					
Шоковая	Шоковый	шоков					
Шуйский	Шуйский	шуйски					
Эвакуация	Эвакуация	эвакуациj					
Эйзенштейн	Эйзенштейн	эйзенштейн					
экономике	экономика	экономик					
экономики	экономика	*					
экономикой	экономика	*					
Экономическая	Экономический	экономическ					
экономическими	экономический	*					
экономических	экономический	*					
Экономическое	Экономический	*					
экономической	экономический	*					
экономическом	экономический	*					
экспорта	экспорт	экспорт					
электростанции	электростанция	электростанциj					
энергоносителей	энергоноситель	энергоноситель					
эпохи	эпоха	эпох					
Эта	Этот	этот					
Эта	этот	*					
этап	этап	этап					
этапа	этап	*					
этапы	этап	*					
Эти	Этот	этот					
это	Этот	*					
Это	Этот	*					
этого	этот	*					
Этот	Этот	*					
Ю.Гагарина	Ю.Гагарин						
Южного	Южный	южн					
юридически	юридически	юридическ					
Юрий	Юрий	юрий					
юриспруденция	юриспруденция	юриспруденциj					
Я.М.Свердлов	Я.М.Свердлов						
явилась	явиться	яви	ся				
явилось	явиться	*					
явилось	явиться	*					
явлением	явление	явлениj					
является	являться	явля	ся				
является	являться	*					
является	является	*					
являлась	являться	*					
являлись	являться	*					
являлось	являться	*					
являются	являться	*					
являются	являться	*					
являются	являться	*					
ядерного	ядерный	ядерн					
ядерных	ядерный	*					
языка	язык	язык					
января	январь	январь					
Японией	Япония	япониj					
Японии	Япония	*					
ярлык	ярлык	ярлык					
Ярослав	Ярослав	ярослав					
ясен	ясный	ясн					
